SO ./textures/wall1.xpm
NO ./textures/wall2.xpm
WE ./textures/wall3.xpm
EA ./textures/wall4.xpm

C  135,206,235
F 91,58,0

1111111111111111
1N0000000000001
100000000000001
100100000010001
101000000001001
100000000000001
1000000010000001
100000000000001
10000000000001
111111111110111
10000000000001
111111111111111